111111111111
1C0000000001
1000CCC00001
1000CPC00001
1E00CCC00001
111111111111
