11111111111111111111111111111
10000C00000000000100000C1P001
11111111111111110001111111101
1C000000000000E101100000C0001
10110111111111110000000111111
100000C00000C0001110111000001
11111111111111100000000011111
1000C0000000000000000000000C1
11111111111111111111111111111
