111111111111111111
100000000000000001
1000P00000000E0001
100000000000000001
10000001100000C001
100000000000000001
10000000C000000001
100000000000000001
100000000000000001
111111111111111111
