11111111111111111111111111111111111111
10000000000000000000000000000000000001
10111100111111011111011111111111111101
100100000000100000C1000000000000000001
10111011111011101111011011111111111101
10E1000010000000000001C000000000000001
10000000000000000000011110011111110001
1010001100000000000000000000010000C001
10000000001111110011111111111111011111
11111111111111110000000000000000000001
1C000000000001000000000100000000000001
111111100010010000000111110000000000C1
100000000010C100000000P01C000000000001
10011101111111000000011111111100000001
10001000000001000000000010000000000001
10001000001000000000000010000001111111
100010000010011111111000100000000000C1
1000C11000100000000C100010000001111111
10000000000000000000000000000000000001
11111111111111111111111111111111111111
