11111
10001
100E1
100C1
11111
