111111111
10C0001E1
100000111
10C000P11
111111111
