11111
10C01
10111
1E1P1
11111
