111111
1P0001
100111
1E01C1
111111
